111111111111111111111111111111111
100000000000000000000000000000001
1C1C1C1C1C1C1C1C1C1C1C1C1C1C1C1C1
100000000000000000000000000000001
1C1C1C1C1C1C1C1C1C1C1C1C1C1C1C1C1
100000000000000000000000000000001
1C1C1C1C1C1C1C1C1C1C1C1C1C1C1C1C1
100000000000000000000000000000001
1C1C1C1C1C1C1C1C1C1C1C1C1C1C1C1C1
100000000000000000000000000000001
1P1C1C1C1C1C1C1C1C1C1C1C1C1C1C1E1
100000000000000000000000000000001
111111111111111111111111111111111