11111111111111111111
100C00C00C00C0010C01
10010010010010010101
10010010010010010101
1CC1CC1CC1CC1CC1C1C1
10011111111111110101
10010010010010000101
10011110011110111101
1P0000000000001E0001
11111111111111111111